гэж	as,that
би	i
өөрийн	his,own
тэр	he,she,would
байсан	was,had,were,did,been
нь	for, with, from, is, to, a/an, in, which, will, fact, whose
дээр	on,up,over
байна	are,have,has,am
тэд	they
байх	be,stay
үед	at,when,during
нэг	one,same,single
энэ	this,it,pron. this
өөр	by,else,another
халуун	hot
үг	word
харин	but,while,rather
ямар	what
зарим	some
хэрэв та	you
буюу	or
олон тоо	the
 -ийн	of
болон	and
бид	we
болох	can,could,may,happen
гарах	out,to leave/exit
бусад	other,rest,except
хийх	do,make,to do
тэдний	their
цаг	time,hour,clock,term
хэрэв	if
хэрхэн	how
гэж хэлсэн	said,told
тус бүр	each
хэлэх	tell
вэ	does
багц	set
гурван	three
хүсэж байна	want
агаар	air
сайн	well,good,better,good
мөн	also,too
тоглох	play,to play
жижиг	small
эцсийн	end,final
тавих	put,lay,to put
нүүр хуудас	home
уншсан	read
гар	hand,arm,arm
порт	port
их хэмжээний	large
ид шид	spell
нэмэх	add
тэр ч байтугай	even
газар	n. land, place, area, station, earth
энд	here,there
байх ёстой	must,should
том	big
өндөр	high,tall,tall
зэрэг	adj. such, order, degree
дагах	follow
акт	act
яагаад	why
асуух	ask,to ask
эрэгтэй	men
өөрчлөлт	change
явав	went
гэрэл	light,shine
төрөл	kind,type
унтраах	off
хэрэгтэй	need
байшин	house
зураг	picture,figure,chart
оролдох	try,to try
ану-ын	us
дахин	again
мал, амьтны	animal
цэг	point
ээж	mother
дэлхийн	world
ойролцоо	near
барих	build,take,hold,catch,touch
өөрөө	self
дэлхий	earth
аав	father,dad
ямар ч	any,no
шинэ	new,fresh
ажил	work,job
хэсэг	n. part, piece, fraction, section, bit, segment
авах	get,to take
хийсэн	made
амьдарч байна	live
хаана	where
дараа	after,then
буцааж	back
бага	little,low,less
нь зөвхөн	only
дугуй	round,wheel,tire,circle
хүн	man,people,who,person
жил	year
ирсэн	came
шоу	show
бүх	every,all
намайг	me
өгөх	give,provide,to give
манай	our
дагуу	under
нэр	name
маш их	very,much,lot
дамжуулан	through
зүгээр л	just
хэлбэр	form,shape
өгүүлбэр	sentence,phrase
агуу их	great
гэж боддог	think
гэж хэлэх	say
туслах	help,to help
мөр	line,string,shoulder
өөр өөр	differ,vary
ээлж	turn
шалтгаан	cause,reason
гэсэн үг	mean,meant
өмнө	prep. before, ago
алхам	move,step
эрх	right
хүү	boy,interest,son,son
хуучин	old
ашиглах	use
таны	your
арга зам	way
тухай	about
олон	many
тэднийг	them
бичих	write,to write
шиг	like
тийм	so
эдгээр	these
түүнийг	her,him
урт	long
зүйл	thing
 -г үзнэ үү	see
хоёр	two
харах	look,watch,view,to see/look at
дэлгэрэнгүй	more
өдөр	day
явах	go,ride,to go/leave for
ирэх	come,arrive,to come
тоо	number,count
сонсогдож	sound
хамгийн их	most
миний	my
мэдэх	know,to know
ус	water
илүү	than
дуудлага	call
эхний	first
доош	down
тал	side
яг одоо	now
олох	find,locate
дарга	head,chair
зогсож	stand
хуудас	page,sheet,slip
улс орон	country,nation
олдлоо	found
хариулт	answer
сургууль	school
ургадаг	grow
судалгаа	study
хэвээр	still
сурах	learn,to study
ургамал	plant
хамгаалах	cover
хоол хүнс	food
нар	sun
дөрвөн	four
хооронд	between
улсын	state
байлгах	keep, carry, retain
нүдний	eye
хэзээ ч	never
өнгөрсөн	last,past
зөвшөөрөх	let
гэж бодсон	thought
мод	tree,wood,stick,wood/tree
гаталж	cross
аж ахуй	farm
хатуу	hard,solid
эхлэл	start
байж болох юм	might
түүх	story,pick,history
харсан	saw
хол	far
далайн	sea
зурж	draw
зүүн	adj. left,east
сүүлээр	late
урсгал	run,flow
хийж чадахгүй	don’t
гэж сонгоод	press,select
ойр	close
шөнө	night
бодит	real
амьдрал	life
хэдэн	few, how many
хойд	north
ном	book
авч явах	carry
авч	took
шинжлэх ухаан	science
идэж	eat
өрөө	room
найз	friend
эхэлсэн	began
санаа	idea
загас	fish
уулын	mountain
зогсоох	stop
нэг удаа	once
үндсэн	base,main,basic
сонсооч	hear
морь	horse
тайрах	cut
байгаа эсэхийг	sure
өнгө	color
нүүр	face,front,lake
нээлттэй	open
шиг санагддаг	seem
хамтдаа	together
дараагийн	next
цагаан	white
хүүхдүүд	children
эхлэх	begin,to start,to begin
авсан	got
алхах	walk
жишээ	example
хөнгөвчлөх	ease
цаас	paper
бүлэг	group
үргэлж	always
дуу хөгжим	music
тэдгээр	those
аль аль нь	both
тэмдэг	mark,sign,symbol
нь ихэвчлэн	often
бичиг	letter
хүртэл	until
милийн	mile
голын	river
машины	car
хөл	n. feet, leg
тусламж	care
хоёр дахь	second
хангалттай	enough
энгийн	plain,simple
охин	girl,daughter
ердийн	usual
залуу	young
бэлэн	ready
дээр дурдсан	above
хэзээ нэгэн цагт	ever
улаан	red
жагсаалт	list
хэдийгээр	though
мэдрэх	feel
хэлэлцүүлэг	talk
шувуу	bird
удахгүй	soon
байгууллага	n. body, organ
нохой	n. dog
гэр бүл	n. family
шууд	direct
загвар	pose
орхих	v. to leave
дуу	song
хэмжих	measure
хаалга	n. door
бүтээгдэхүүн	product
хар	black
богино	short
тооны нэр	numeral
анги	class
салхины	wind
асуулт	question
бүрэн	adj. complete, full
хөлөг онгоц	ship
тэн	equal 
хагас	half
чулуулгийн	rock
гал түймэр	fire
урд	south
асуудал	problem,matter
мэдэж байсан	knew
өнгөрөх	pass
учир	since
дээд	top
бүхэлд	whole
хаан	king
гудамж,	street
инчийн	inch
үржүүлэх	multiply
юу ч биш	nothing
мэдээж	course
хүч	force
хөх	adj. blue
объект	object
шийдвэр	decide
газрын гадаргын	surface
гүн гүнзгий	deep
сар	moon
арал	island
систем	system
завгүй	busy
туршилтын	test
бичлэг	record
завь	boat
нийтлэг	common
алт	gold
аль болох	possible
нисэх онгоц	plane
үүний оронд	stead
хуурай,	dry
гайхдаг	wonder
инээд	laugh
мянган	thousand
гүйж	ran
шалгах	check
тоглоом	game
тэнцэхгүй	equate
өнгөрөөх	miss
авчирсан	brought
дулаан	heat,warm,warm
цас	snow
авчрах	bring
хэрэв тийм бол	yes
холын	distant
бөглөх	fill
будаг	paint
хэл	language, tongue
дунд	adj. among, middle, satisfactory
нэгж	unit
эрчим хүч	power
нарийн	fine, thin
тодорхой	certain,clear
ялаа	fly
унах	fall,to fall
хүргэдэг	lead
хашхирах	cry
харанхуй	dark
машин	machine,car
тэмдэглэл	note
хүлээх	wait,to wait
төлөвлөгөө	plan
од	star
хайрцаг	box
нэр үг	noun
талбар	field
зөв	correct,proper
боломжтой	able
фунт	pound
хийгдсэн	done
гоо сайхан	beauty
хөтөч	drive
зогсов	stood
агуулсан	contain
заах	teach,to teach
долоо хоног	week
өгсөн	gave
ногоон	green
өө	oh
хурдан	quick
боловсруулах	develop
далай	ocean
чөлөөт	free
минут	minute
хүчтэй	strong
тусгай	special
оюун ухаан	mind
ард	behind
сүүл	tail
үйлдвэрлэх	produce
орон зай	space
сонслоо	heard
хамгийн сайн	best
үнэн	true
зуун	hundred
таван	five
санаж	remember
эрт	early
баруун тийш	west
газрын	ground
хүрэх	reach,to touch
үйл үг	verb
дуулах	sing,to sing
сонсох	listen,to listen
зургаан	six
хүснэгт	table
аялал жуулчлалын	travel
өглөө	morning
арван	ten
хэд хэдэн	several
эгшиг	vowel
рүү	toward
дайн	war
эсрэг	against,opposite
хэв маяг	pattern
удаан	slow
төв	center
хайр	love,favor
мөнгө	money
үйлчлэх	serve,to serve
гарч ирэх	appear
авто зам	road
газрын зураг	map
бороо	rain
дүрэм	rule
удирдах	govern
татах	pull
хүйтэн	cold
мэдээлэл	notice
дуу хоолой	voice
эрчим хүчний	energy
ан	hunt
магадлалтай	probable
ор	bed
ах дүү	brother
өндөг	egg
эсийн	cell
гэдэгт итгэдэг	believe
магадгүй	perhaps
гэнэт	sudden
дөрвөлжин	square
төлөөлөх	represent
урлаг	art
хичээл	subject
бүс нутаг	region
хэмжээ	size,deal
барагдуулах	settle
үг хэлэх	speak
жин	weight
ерөнхий	general,chief
мөс	ice
тойрог	circle
хос	pair
оруулах	include
хуваагдал	divide
үет	syllable
эсгий	felt
их	grand,a lot of
бөмбөг	ball
одоогоор	yet
долгионы	wave
унагаах	drop
зүрхний	heart
өнөөгийн	present
хүнд	heavy
бүжгийн	dance
хөдөлгүүр	engine
албан тушаал	position
өргөн	wide,broad
онгоцны далбаа	sail
материал	material
ой	forest
суух	sit,to sit
уралдаан	race
цонх	window
дэлгүүр	store,shop,stores,electronics store,antique shop
зуны	summer
галт тэрэг	train
унтах	sleep,to sleep
нотлох	prove
цорын ганц	lone
хөлөө	leg
дасгал	exercise
ханын	wall
холбох	mount,connect
хүсвэл	wish
тэнгэр	sky
туз-ийн	board
баяр хөөр	joy
өвөл	winter
орохдоо	sat
бичсэн	written,wrote
зэрлэг	wild
арга хэрэгсэл	instrument,tool
хадгалах	kept,save
шилэн	glass
өвс	grass
үнээ	cow
зах	edge,market
айлчлал	visit
зөөлөн	soft,gentle
хөгжилтэй	fun
гэрэл гэгээтэй	bright
хий	gas
цаг агаар	weather
сарын	month
сая	million
үүрэх	bear
барианы	finish
аз жаргалтай	happy
гэдэгт найдаж байна	hope
цэцэг	flower
хувцаслан	clothe
хачин	strange
илааршсан	gone
гадаад худалдааны	trade
аялгуу	melody
аялал	trip,hiking
оффис	office
хүлээн авах	receive
эгнээ	row
агшин	mouth
яг	exact,quite
үхэх	die
наад зах	least
гай	trouble
орө	shout
үрийн	seed
ая	tone
нэгдэхийг	join
санал болгож байна	suggest
цэвэр	clean
завсарлага	break
эмэгтэй	lady,woman
талбай	yard,squire
босох	rise,to get up
муу	bad
цохилт	blow
газрын тос	oil
цусны	blood
өссөн	grew,rose
хувь	cent
холино	mix
баг	team
утас	wire,thread
зардал	cost
алдагдсан	lost
бор	brown
өмсөж	wear
цэцэрлэг	garden
тэнцүү	equal
илгээсэн	sent
сонгох	choose,to choose
буурсан	fell
таарах	fit,to fit
шударга	fair
банк	bank
цуглуулах,	collect
хяналтын	control
аравтын	decimal
чихний	ear
эвдсэн	broke
хэрэг	case
алах	kill
мөч	moment
хэмжээний	scale
чанга	loud
хавар	spring
ажиглах	observe
хүүхэд	child,baby
шулуун	straight
гийгүүлэгч	consonant
ончтой үр дүн	dictionary
сүү	milk
хурд	speed
арга	method
төлөх	pay,to pay
нас	age
хувцас	dress,clothes
үүл	cloud
гайхуулах	surprise
нам гүм	quiet
чулуу	stone
жижигхэн	tiny
өсөх	climb
сэрүүн	cool
зураг төсөл	design
ядуу	poor
туршилт	experiment
доод	bottom
гол	key,stream,major,river
төмрийн	iron
хавтгай	flat
хорин	twenty
арьс	skin
инээмсэглэл	smile
уртасгахад	crease
нүх	hole
үсрэх	jump,to jump
найман	eight
тосгон	village
хангасан	meet
эх	root,original
худалдан авах	buy,to buy
өсөлт	raise
шийдвэрлэх	solve
металл	metal
эсэх	whether
түлхэх	push
долоон	seven
догол	paragraph
гурав дахь	third
болно	shall
зохион байгуулав	held
үс	hair
тайлбарлах	describe,to explain
тогооч	cook,cook/chef
шал	floor
аль нэг	either
үр дүн	result
шарах	burn
толгой	hill,head
аюулгүй	safe
муур	cat
зууны	century
авч үзэх	consider
хууль	law
эрэг	coast,shore
хуулбар	copy
чимээгүй	silent
элс,	sand
хөрс	soil
өнхрөх	roll
температур	temperature
хуруу	finger
аж үйлдвэрийн	industry
үнэ цэнэ	value
тэмцэл	fight
худал	lie
зодож	beat
сэтгэл татна	excite
байгалийн	natural
мэдрэмж	sense
капитал	capital
тийм юм байхгүй	won’t
аюул	danger
жимс	fruit
баян	rich
зузаан	thick
цэрэг	soldier
үйл явц	process
үйл ажиллагаа явуулах	operate
практик	practice
тус тусад	separate
хүнд хэцүү	difficult
эмч,	doctor
үү	please
хамгаалах,	protect
үд	noon
газар тариалан	crop
орчин үеийн	modern
элемент	element
хит	hit
оюутан	student
булангийн	corner
нам	party
хангамж	supply
бөгж	ring
тэмдэгт	character
шавьж	insect,insects
татлаа	caught
хугацаа	period
харуулж байна	indicate
радио	radio
ярьсан	spoke
атомын	atom
хүний	human
үр нөлөө	effect
цахилгаан	electric,lightening/bolt
найдах	expect
ясны	bone
төмөр замын	rail
төсөөлж	imagine
санал нэгтэй	agree
ийн	thus
ахмад	captain
таах	guess,to guess
шаардлагатай	necessary,require
хурц	sharp
жигүүр	wing
бий болгох	create
хөрш	neighbor
угаалгын	wash
бат	bat
олон хүн	crowd
эрдэнэ шиш	corn
харьцуулах	compare
шүлэг	poem
хонх	bell
хамааралтай	depend
мах	meat
урэх	rub
хоолой	tube
алдартай	famous
доллар	dollar
айдас	fear
нүдний хараа	sight
нимгэн	thin
гурвалжин	triangle
гариг	planet
яарах	hurry
колони	colony
уул уурхайн	mine
зангиа	tie
оруул	enter
хайлт	search
илгээх	send
шар	yellow
буу	gun
боломж олгох	allow
хэвлэх	print
нас барсан	dead
спот	spot
цөлийн	desert
нэхэмжлэл	suit,claim
одоогийн	current
өргөгч	lift
мастер	master
зам	track,path,road
эцэг, эх	parent
хэлтэс	division
бодис	substance
дараах	post
зарцуулах	spend
хөвч	chord
өөх	fat
баяртай	glad
эзлэх хувь	share
талх	bread
үнэ	charge,price
бар	bar,tiger
санал болгох	offer
боол	slave
нугас	duck
шуурхай	instant
зах зээлийн	market
нутагшуулах	populate
дэгдээхэйн	chick
хайрт	dear
дайсан	enemy
хариулах	reply,to answer
ундаа	drink,beverages,soda
тохиолддог	occur
дэмжлэг үзүүлэх	support
хэл яриа	speech
мөн чанар	nature
хүрээ	range
уурын	steam
хөдөлгөөн	motion
шингэн	liquid
гуалин	log
коэффицентийг	quotient
шүд	teeth,tooth
бүрхүүл	shell
хүзүү	neck
хүчилтөрөгчийн	oxygen
элсэн чихэр	sugar
үхэл	death
нэлээн	pretty
ур чадвар	skill
эмэгтэйчүүд	women
улирал	season
үүний шийдэл	solution
соронз	magnet
мөнгөн	silver
талархлын	thank
салбар	branch
хүсч байгаа эд зүйлс	match
дагавар	suffix
ялангуяа	especially,particular
инжрийн	fig
айдаг	afraid
асар их	huge
эгч	sister
ган	steel
хэлэлцэх	discuss
урагш	forward
ижил төстэй	similar
чиглүүлэх	guide
туршлага	experience
оноо	score
алим	apple
худалдан авсан	bought
удирдуулсан	led
давирхай	pitch
цув	coat,rain coat
олон нийтийн	mass
карт	card
хамтлаг	band
олс	rope
хожил	win
мөрөөдөж	dream
орой	evening
нөхцөл байдал	condition
малын тэжээл	feed
нийт	total
үнэр	smell
хөндий	valley
ч	nor
давхар	double
суудал	seat
үргэлжлүүлэх	continue
блок	block
малгай	hat
борлуулах	sell
амжилт	success
компани	company
хасах	subtract
үйл явдал	event
усанд сэлж	swim
эхнэр	wife
гутал	shoe,boots
мөрөн	shoulder
тархах	spread
зохион байгуулах	arrange
бааз	camp
зохион бүтээх	invent
хөвөн	cotton
төрөлхийн	born
тодорхойлох	determine
есөн	nine
ачааны машин	truck
дуу чимээ	noise
түвшин	level
боломж	chance
цуглуулах	gather
сунгах	stretch
хаях	throw
үл хөдлөх хөрөнгийн	property
багана	column
молекул	molecule
буруу	wrong
саарал	gray
давтан	repeat
бэлтгэх	prepare
давс	salt
хамар	nose
олон тооны	plural
уур хилэн	anger
тив	continent
бүр	n. everyone
сайхан	adj. nice,fine/nice
урьд	prep. before
тогтох	v. determine
өмгөр	adj. very narrow
нэгэн	art. a/an
өвгөн	n. old man
эмгэн	n. old woman
чинээ	n. size
энх	adj. peaceful
эрүүл	adj. healthy
саруул	adj. clear,lucent,serenity
амьдрах	v. to live,to live
гэх	v. to say
зовлон	n. suffering
гараа	n. starting point
муудах	v. to decay
хаяанд	prep. nearby
хөөрхий	adj. pitiful
дуудах	v. to call,to call out
хажуу	prep. edge,side
хүүхэлдэй	n. doll
сонс	interj. i say!
хэн	pron. who
битгий	do not
үзүүлэх	v. to show
хэрвээ	conjunc. if
чамд	pron. you
тохиолдох	v. to occur
хооллох	v. to feed
яах	adv. how
зөвлөх	v. to suggest
сэтгэл	n. spirit
ингэх	in this way/manner
үнсэх	v. to kiss,to kiss
нас барах	v. to die,to die
харамсан	adv. pitifully
гашуудах	v. to grieve
нэлээд	adv. much
удсан	adj. mature, stale
авгай	n. aged woman
ууртай	adj. angry
чинь	pron. me
догшин	adj. fierce
зантай	adj. grumpy
хорон	adj. mischievous
хойт	adj. step-(family member) e.g. step-parent
хорлох	v. to hurt
хорлонтой	adj. evil
цамаан	adj. fastidious
үлдэх	v. continue,remain,to stay
хорогдох	v. crouch,dwindle,escape,linger
эцэг	n. parent,father
гандах	v. crumble,wilt,wither
галлах	v. fire (to burn?)
зуух	v. to bake, bite,stove
зөөх	v. to carry,transfer,to carry
цэвэрлэх	v. to clean,to clean
шан	n. compensation,fee
сүүдэр	n. shade
тайвшруулах	v. to appease,console
уух	v. to drink,to drink
амсах	v. to sample,savor
уулга	n. yell,cry
байгаа	adj. existent
түгжих	v. to lock, fasten
дотроо	prep. inwards
пин	n. barn
саах	v. to milk
гэгч	adj. so-called
өнөөх	v. inherent
болгох	v. to convert,render
болгон	adj. every
үзэсгэлэнтэй	n. beauty, loveliness
хэлшгүй	adj. unspeakable
үлгэр	n. fable, fairytale
улам	adj. more
төрөх	v. to give birth,to be born
төрүүлэх	v. to generate
цаана	adj. beyond,farther
хав	n. doggy
усан	adj. aquatic
цутгах	v. to cast, flood, stream
салхи	n. wind,wind/breeze
шуугих	v. jangle, fizz, clutter
намар	n. autumn,autumn
эргэ	n. precipice, steep rock or cliff
тойрох	v. to beset, circle
сүг	n. apparition, ghost
тор	n. cage, mesh, net
нэхэх	v. to weave, chase
нөгөө	adj. other
оймс	n. footgear, stockings,socks
ээрэх	v. to falter, hesitate, to spin
оноох	v. to appoint, impose, mete
тэгээд	adv. then
охид	n. girl, sister
ажиллах	v. to do, get, work,to work
ганц	adj. lone single
баллуур	eraser
гэрийн даалгавар	homework
дэвтэр	notebook
маш	very
онц	excellent
самбар	white board
сандал	chair
спорт заап	gym
сурагч ширээ	desk
толь бичиг	dictionary
үзүүрлэгч	sharpener
үзэг	pen
үсэг	letter
хавтас	cover/folder
харандаа	pencil
цавуу	glue
цагийн хуваарь	timetable of lesson
цэцгийн сав	flower pot
шалгалт	test
ширээ	table
шугам	ruler
эгшиг үсэг	vowel
хүнсний ногоо	vegetable
байцаа	cabbage
вандуй	peas
лууван	carrots
өргөст хэмх	cucumber
перец	black pepper
сонгино	onion
төмс	potato
улаан лууван	radish
улаан лооль	tomato
улаан манжин	beet
хулуу	pumpkin
чинжүү	green pepper
шар лууван	carrot
шош	beans
буурцаг	beans
шар манжин	turnip
амтат зүрж	orange
бөөрөлзгөнө	raspberry
бэрсүүт жүрж	tangerine
гадил	banana
гүзээлзгэнэ	strawberry
интоор	cherry
киви	kiwi
лийр	pear
нимбэг	lemon
нэрс	blueberry
тарвас	watermelon
тоор	peach
усан үзэм	grape
үзэм	raisin
хад	currant,госк
хан боргоцой	pineapple
чангаанз	apricot
чавга	plum
тариа	cereal
бялуу	cake/pie
бин	pancake
гамбир	pancake
гурил	flour
гоймон	noodles
жигнэмэг	biscuit/cookies
зуурсан гурил	dough
өрмөнцөр	waffle
үр тариа	grain
будаа	rice
амттан	spices
ёотон	lump suger/cube
мax	meat
адууны мах	horse meat
гахайн мах	pork
гахайн утсан мах	bacon
зайдас	hot dog
өндег	egg
тахианы мах	chicken
тарваганы мах	marmot
үхрийн мах	beef
хонины мах	mutton
хиам	sausage
хоол	meals
зууш	dessert/snack
оройн хоол	dinner
өдрийн хоол	lunch
өглөөний цай	breakfast
хээрийн хоол	picnic
шөл	soup
цагаан идээ	dairy products
бяслаг	cheese
зайрмаг	ice-cream
тараг	yogurt
хайлмаг	melted butter
цөцгийн тос	butter
цөцгий	cream
дарс	wine
жимсний шүүс	juice
кофе	coffee
цай	tea
шар айраг	beer
гал тогооны хэрэгсэл	kitchen utensils
аяга	bowl
будаа агшаагч	rice cooker
данх	kettle
дийз	saucer
махны машин	meat grinder
өндөг хагалагч	egg beater
сэрээ	fork
савх	chopstick
сэнжтэй аяга	cup
таг	lid/cover
таваг	plate
тогоо	potato
ус буцалгагч	water boiler
хайруулын таваг	frying pan/skillet
хутга	knife
холигч	mixer
халбага	spoon
хапуун сав	thermos
хундага	glass
шарагч	broiler
шанага	ladle
шүүр	strainer,broom
шарах шүүгээ	oven
агуулах	storage
эоорь	storage
алчуур	towel
аяганы шүүгээ	cupboard
буйдан	sofa
бие засах өрөө	restroom
галын өрөө	kitchen
гадаа жорлон	outhouse
граш	garage
зурагт	television/tv
дэр	pillow
дээвэр	ceiling
тааз	ceiling
жорлон	toilet
зочны өрөө	living room
зөөлөн сандал	armchair
индүү	iron
индүүний ширээ	ironing board
орны даавуу	sheets
оёдлын машин	sewing machine
паар	radiator
суурь	basement
тавилга	furniture
тагт	balcony
телефон утас	telephone
тоос сорогч	vacuum cleaner
түлхүүр	key
yraaryyp	sink
угаалгын машин	washing machine
угаалгын өрөө	bath/laundry room
унждаг чийдэн	light
усанд орох онгоц	bathtub
үүдний өрөө	hall
ширээний бүтээлэг	table cloth
ширээний чийдэн	lamp
шүршүүр	shower
хана	wall
ханын шүүгээ	closet
хашаа	yard
хивс	carpet/rug
хогийн гаргуул	dust pan
хоолны өрөө	dining room
хөгжим	tape recorder,music
хөнжил	blanket
хөргөгч	refrigerator/fridge
хөшиг	curtain
хүүхдийн өрөө	kid’s room
цонхны тавцан	window sill
шалны хулдаас	linoleum
яндан	chimney
булган малгай	sable hat
бүс	belt
бээлий	gloves
гутлын үдээс	shoe string
гэрийн шаахай	slippers
даашинз	dress
дотуур хувцас	briefs
дотуур цамц	t-shirt
жинс өмд	jeans
майк	undershirt
ноосон цамц	sweater
ороолт	scarf
өмд	pants/trousers
пальто	coat
пиджак	blazer
пүүз	sneakers/running shoes
татуурга	suspenders
тирко оймс	nylons/tights
шилэн оймс	nylons/tights
туфль	high heel shoes
тэлээ. бүс	belt
унтлаганы хувцас	night gown
урт оймс	stockings
усны хувцас	swim suit
халат	house dress
хантааз	vest
хормогч	apron
хослол	suit
хүрэм	jacket
эмэгтэй цамц	blouse
эрэгтэй цамц	shirt
шуба	fur coat
юбка	skirt
ax	brother
ач охин	niece
зээ охин	niece
ач хүү	nephew
зээ хүү	nephew
авга ах	uncle
нагац ах	uncle
бэр эгч	sister in law
бэр дүү	sister in law
нагац эгч	aunt
авга эгч	aunt
насанд хүрсэн хүн	adult
нөхөр	husband
өвөө	grandfather
үеэл	cousin
хамаатан садан	relatives
хүргэн ах	brother in law
хүргэн дүү	brother in law
эмэгтэй хүн	woman
эмэгтэй хүүхэд	girl
эмээ	grandmother
эрэгтэй хүн	man
эрэгтэй хүүхэд	boy
эцэгэх	parents
гаригууд	days of the week
даваа	monday
мягмар	tuesday
лхагва	wednesday
пүрэв	thursday
баасан	friday
бямба	saturday
ням	sunday
цаг хугацаа	time
ажлын өдөр	weekday
амралтын өдөр	weekend
дараа жил	next year
3 өдрийн өмнө	3 days ago
заримдаа	sometimes
ихэвчлэн	usually
маргааш	tomorrow
нар жаргасан орой	sunset
нар мандах үе	sunrise
нөгөөдөр	day after tomorrow
нэг цаг	hour
өчигдөр	yesterday
өдөр бүр	every day
өчигдөр орой	last night
cap	month
сарын дараа	after a month
уржигдар	day before yesterday
үдээс хойш	afternoon
үд дунд	noon
хараахан	yet
хоног	day/24 hours
2 жилийн өмнө	2 years ago
шөнө дунд	midnight
улиралууд	seasons
зун	summer
байгаль	nature
аянга	thunder
газар хедлелт	earthquake
ган гачиг	drought
зэрэглээ	mirage
манан	fog
мөндөр	hail
нуур	lake/pond
рашаан	spring
солонго	rainbow
уул	mountain
халуун хүйтэн	temperature
хунгар	drift
цан	frost
цасан шуурга	blizzard
шавхай	slush
шиврээ бороо	drizzle
шороо	soil
шуурга	storm
элс	sand
амьтад	animals
алаг тахь	zebra
анааш	giraffe
арслан	lion
баавгай	bear
буга	deer
булга	sable
бух	bull
гахай	pig
гөлөг	puppy
гөрөөс	antelope
гүрвэл	lizard
заан	elephant
зараа	hedgehog
зурам	gopher
илжиг	donkey
ирвэс	leopard
ишиг	kid
могой	snake
мэлхий	frog
сармагчин	monkey
сарлаг	yak
тарвага	marmot
торой	piglet
тугал	calf
туулай	hare/rabbit
тэмээ	camel
унага	foal
үнэг	fox
үхэр	cow
үхэр хулгана	rat
халим	whale
хандгай	elk/moose
хонь	sheep
хулгана	mouse
хурга	lamb
хэрэм	squirrel
чоно	wolf
шанаган хорхой	tadpole
шар үхэр	ox
шилүүс	lynx
ямаа	goat
яст мэлхий	turtle/tortoise
аалз	spider
жоом	cockroach
бясаа	bug
зөгий	bee
хачиг	tick
хувалз	tick
царцаа	grasshopper
шоргоолж	ant
цох хорхой	ladybug
шумуул	mosquito
эрвээхэй	butterfly
болжмор	lark/sparrow
бүргэд	eagle
галуу	goose
тахианы дэгдээхэй	chicken
тагтаа	pigeon
тогоруу	crane
тоншуул	woodpecker
тоть	parrot
хараацай	swallow
хөхөө	cuckoo
хун	swan
хэрээ	crow
шаазгай	magpie
шар шувуу	owl
шонхор	falcon
цацагт хяруул	turkey
элээ	vulture
тас	vulture
ятуу	grouse
дэс тоо	ordinal numbers
дүрс	shapes
долоон енцөгт	heptagon
зургаан өнцөгт	hexagon
зууван	oval
конус	cone
куб	cube
мушгиа	spiral
найман өнцөгт	octagon
өнцөг	angle
пирамид	pyramid
таван өнцөгт	pentagon
тэгш өнцөгт	rectangle
хүний бие	parts of the body
алга	palm
ам	mouth
бугуй	wrist
булчин	calf
гарын сарвуу	hand
гуя	thigh
гэдэс	stomach
магнай	forehead
дух	forehead
мэнгэ	birthmark
нуруу	back/spine
нүд	eye
өвдөг	knee
өгзөг	buttocks
өсгий	heel
сормуус	eyelash
суга	armpit
ташаа	hip
тохой	elbow
уруул	lip
хацар	cheek
хөлийн тавхай	foot
хөмсөг	eye brow
хелийн хуруу	toe
хумс	finger nail
хүй	navel
цээж	chest
чих	ear
шагай	ankle
эрүү	chin
эрхий хуруу	thumb
яс	bone
эдлэлийн	jewelry store
бичгийн хэрэгслийн	stationary
гутлын дэлгүүр	shoe store
зоогийн газар	restaurant
их дэлгүүр	department store
ломбард	pawn shop
номындэлгүүр	book store
ногооны мухлаг	vegetable stand
сонины мухлаг	newsstand
спортын барааны	sporting goods store
талхны	bakery
тасаг	department
тооцоо	bill
уран зургийн	art gallery
үйлчилгээний төв	service center
хариулт мөнгө	change
хивсний дэлгүүр	carpet store
хувцасны дэлгүүр	clothing store
худалдааны төв	shopping center
хөгжмийн дэлгүүр	music store
хүнсний дэлгүүр	grocery store
хүнсний зах	supermarket
цайны газар	cafeteria
эмийн сан	drugstore
суурин	town
автобус	bus
автобусны буудал	bus stop
авто зогсоол	parking lot
амьтны хүрээлэн	zoo
барилга	building
байр.сууц	apartment
гудамж	street
дүүрэг	district
кино	movie/film
кино театр	cinema
концерт	concert
музей	museum
өргөн чөлөө	avenue
сүм	church
театр	theater
усан сан	swimming pool
үзэсгэлэн	exhibition
үйлдвэр	factory
хот	n. city, town
хороолол	micro district
хүн ам	population
цэнгэлдэх хүрээлэн	stadium
цагдаагийн газар	police station
цирк	circus
шөнийн клуб	night club
шуудан	post office
эмнэлэг	hospital
эрүүл мэндийн төв	health center
спорт ба тоглоом	sports and games
аварга	champion
алхалт	jogging
ан агнуур	hunting
бильярд	billiards
боулинг	bowling
бокс	boxing
бөхийн барилдаан	wrestling
гар бөмбөг	volleyball
гимнастик	gymnastics
гүйлт	running
дасгалжуулагч	trainer
дугуй уналт	bicycling
морь уналт	horse riding
өрселдөгч	competitor
поло	polo
сагсан бөмбөг	basketball
сур	archery
байт сур	archery
теннис	tennis
тэмцээн	competition
усан сэлэлт	swimming
хожигдогч	loser
хоккей	hockey
хөл бөмбөг	football
хүндийн өргөлт	weight lifting
цанын спорт	skiing
цом	cup
шатар	chess
ширээний теннис	ping pong
эмээл	saddle
ялагч	winner
ажил алба	jobs and work
аж ахуйн эзэн	farmer
багш	teacher
бие хамгаалагч	bodyguard
бизнесмен	businessman
бичээч	typist
бүжигчин	dancer
гал сөнөөгч	fireman
гоо сайханч	beautician
гэрийн багш	tutor
дуучин	singer
жолооч	driver
жүжигчин	actor/actress
зохиолч	writer
зураач	artist
илбэчин	magician
инженер	engineer
касс	cashier
менежер	manager
механик	mechanic
мөрдөгч	detective
мужаан	carpenter
ня-бо	accountant
орчуулагч	translator
сэтгүүлч	journalist
талхчин	baker
цагдаа	policeman
уих-ын гишүүн	parliament
үсчин	barber
хаалгач	doorman
харваач	archer
хөлсний ажилчин	wage worker
хуульч	lawyer
цэвэрлэгч	cleaner
шууданч	postman
шүдний эмч	dentist
шүүгч	judge
эмч	doctor
худалдаа	business
наймаа	business
албан татвар	tax
баланс тэнцэтгэл	balance
барьцаа.зээл	mortgage
бэлэн мөнгө	cash
гэрээ, хэлцэл	contract
данс тооцоо	account
жилийн тайлан	annual report
зээл	credit
орлого	income
өртөг шан	fee
өр төлбөр	debt
санхүү-н шалгалт	audit
сонирхол	interest
түрээс	rent
удирдлага	management
үнэт цаас	bond
үнэ өртөг	cost
хандив	donation
хөрөнгө	capital
хөдөлмөрийн  гэрээ	labor contract
хөрөнгө оруулалт	investment
худалдаа	commercial
хувь ноогдол	quota
хувьцаа	stock
хувьцааны ноогдол	value
хүү.хувь	profit
цалингийн цэс	payroll
цалин хөлс	wage/salary
цуцлалт	write off
эдийн засаг	economy
эд юмс ба багаж	tools
алх	hammer
амны алчуур	napkin
бахь	pliers
бугуйвч	bracelet
бугуйн цаг	watch
гар цүнх	handbag
зангианы хавчаар	tie tack/clip
зүү	needle
зээлийнкарт	credit card
нимгэн цаас	tissues
нусны алчуур	handkerchief
нүдний шил	eyeglasses
сам	comb/brush
сойз	toothbrush
сүх	axe
тооны машин	calculator
түлхүүрийн оосор	key chain
түрийвч	wallet
үдээсний машин	stapler
үсний хавчаар	hairpin
хадаас	nail
хайч	scissors
хаягийн ном	address book
хөзөр	deck of cards
хөрөө	saw
хуруувч	thimble
хүзүүний зүүлт	necklace
цаасны хавчаар	paper clips
цүнх	briefcase
шүхэр	umbrella
ээмэг	earrings
үйл үгс	verbs
айх	to be afraid
аялах	to travel
барих	to build
барилга	to build
барьж авах	to catch
бодох	to think
болох	to be
байх	to be
бороо орох	to rain
будах	to paint
буцалгах	to boil
бүжиглэх	to dance
гайхах	to be surprised
гэрлэх	to be married
дуу гаргах	to sound
дуртай	to like
дуусах	to finish
жолоодох	to drive
завгүй байх	to be busy
завтай байх	to be free
зажлах	to chew
зарцуулах	to spend
өнгөрөөх	to spend
зогсох	to stand
зочлох	to visit
зөв бичих	to spell
зурах	to draw
идэх	to eat
инээх	to smile
итгэх	to believe
мартах	to forget
мөлхөх	to climb, crawl, creep
мөнгө олох	to earn
наах	to stick
нисэх	to fly
оёх	to sew
ойлгох	to understand
онгойлгох	to open
орилох	to shout
орчуулах	to translate
өвдөх	to be sick
өлсөх	to be hungry
өмсөх	to wear
зүүх	to wear
сайжруулах	to improve
санах	to remember
солих	to change
сэлэх	to swim
сэрэх	to wake up
таалах	to enjoy
тайлах	to take off
талархах	to be glad
товч тайлах	to unbutton
тоолох	to count
түрүүлэх	to win
тэвчих	to endure
тэжээх	to feed
тэмдэглэх	to celebrate
угаах	to wash
уйлах	to cry
унших	to read
урих	to invite
усанд орох	to bathe
утсаар ярих	to call
уулзах	to meet
уурлах	to get angry
үзэх	to see
үнэрлэх	to smell
хаах	to close
хагалах(мод)	to chop (wood)
хазах	to bite
хаях	to throw
шидэх	to throw
хоол хийх	to cook
хоцрох	to be late
хөлрөх	to sweat
хөдлөх	to move
хөхрөх	to laugh
хувилах	to copy
худалдах	to sell
хүсэх	to want
хүрч ирэх	to arrive
хэвтэх	to lie
хэрэглэх	to use
хэрчих	to cut
хэрэгтэй байх	to need
цадах	to get full
цангах	to be thirsty
цас орох	to snow
цахилгаан татах	to zipper
цоожлох	to lock
чадах	to be able
чанах	to brew
шумбах	to dive
эвдэх.хагалах	to break
эргэх	to turn
эрэх	to look for
хайх	to look for
ядрах	to tire
ярих	to speak
ярилцах	to talk
тэмдэг нэр	adjectives
алтан	gold
амархан	easy
анхны	first
бага зэрэг	a little bit
бороотой	rainy
бохир	dirty
буржгар	curly
бүдүүн	thick
бүрхэг	overcast
гоолиг	slender
гоё	beautiful
дундуур	half full
дүүрэн	full
жаахан	a little
залхуу	lazy
зөвхөн	only
илүү сайн	better
инээдтэй	funny
муухай	ugly
намхан	short
нартай	sunny
нил ягаан	violet/purple
өвчтэй	sick
өтгөн	strong
салхитай	windy
тарган	fat
тоостой	dusty
тэнэг	stupid
тэгш	flat
ухаантай	clever
үнэтэй	expensive
халтиргаатай	slippery
хамгийн муу	worst
хөгшин	old
хуурай	dry
хүрэн	brown
хэцүү	difficult
хямдхан	cheap
цайвар шаргал	beige
цастай	snowy
цөөхен	few
шаргал	orange
шингэн	weak
сул	weak
эвдэрхий	broken
ягаан	pink/rose
асуух үг	question words
аль	which
хаашаа	where to
хаанаас	where from
хэзээ	when
хэнд	to whom
хэний	whose
хэр их	how much
хэр олон	how often
юу	what
юунд	to what
яаж	how
үлдээх	v. to void, omit
асах	v. to ignite
тэртээ	prep. beyond
нийлэх	v. to unite
очих	v. to visit
хашхиралдах	v. to yell
хашгиралдах	v. to yell
гаргах	v. to launch, issue
гялайлаа	thank you
цааш	adj. farther
хойно	adj. then, after, behind
харлах	v. to feel sick or faint, to darken
мичид	n. evening star
гэрэлтэх	v. to shine
чичрэх	v. to shake
элгэн	adj. chesnut,maroon
цав	n. fissure, slit
цалин	n. salary
хазаар	n. bridle, bit
торгон	n. silk
давхих	v. to gallop
үүр	n. dawn
цайх	v. to dawn
хожуул	n. stump,stub
бут	n. bush
арай	adj. near
ядах	v. to have difficulty
арай ядан	adj. barely, hardly
шүүдэр	n. dew
бүрхэх	v. to cover
хөрөх	v. to freeze
хөших	v. to become numb, stiff
ухаа	adj. reddish
хонгор	adj. lovable
мандах	v. to rise
ээх	v. to warm
дулаацуулах	v. to heat up
хяруу	n. white frost
хатаах	v. to dry
өдөржингөө	adv. all day long
аглаг	n. solitude
тойруулах	v. to encircle, get around
гавал	n. skull
цүү	n. spike
балмагдах	v. to be afraid
хөшөө	n. monument, memorial
мэт	adj. somewhat
шингэх	v. to be absorbed, soaked, set
дээрх	prep. above
гэгээ	n. daylight, glow
дагжих	v. cower, shake
чичирсэн	adj. shivery, tremulous
аймшиг	n. awe, fear
зугтах	v. to avoid, flee
шигдэх	v. to sag, sink
доргих	v. to chatter, jiggle, vibrate
сүр	n. grandeur, majesty
чимээ	n. clamour, news, noise, word
бол	and, are, hold
суугаа	n. resident
нүдүүр	n. beater, pounder
шүүрдэх	v. to sweep, whisk
ирмэг	n. border, edge
дөхөх	v. to approach
доор	prep. below, beneath
бөхийх	v. to bend, bow
дор	prep. downstairs, under
даруу	adj. decent, humble, lowly
ир	n. blade, edge, spike
явуулах	v. despatch, send
хамаатан	n. kin, relative
цүг	adj. together
олдох	v. to be available
гэсэх	v. defrost
бат	adj. firm, steady
бөх	adj. firmness, strong
онгойх	v. to open
баялаг	n. abundance, exuberance, gold
үүд	n. gate, portal
нээгдэх	v. to open
хашгирах	v. exclaim, shout
урах	v. to germinate,grow
гуядах	v. flog
завдах	v. to intend, manage
хус	n. boy
орчих	v. spin, wheel
үүн	pron. it
бүү	no
шавхуурдах	v. flog, smack
дагуулах	v. append, guide
болиулах	v. cease, suspend
дэргэд	prep. beside, near
ухасхийх	v. recoil
хахир	adj. rugged, stern
над	pron. me
амар	n. rest, peaceful
маажих	v. to scratch
вандан	n. board, bench
хувин	adj. pitcher, bucket
дэгдээх	v. to stir up
дөчин	adj. forty years
аяга	n.	cup
дэгдээхий	adj. fledgling
нугас	n. duck, brain
боов	n. bun,turnover
амтат	adj. sweet
бал	n. noun
хөөсрөх	v. to foam, froth
исгэлэн	adj. eager, sour
хэм	n. degree, measure
цөм	n. core, nucleus
булан	n. anger, angle, nook
шуудай	n. bag, sack
ялгаа	n. departure, discrepancy, difference
биелүүлэх	v. to fulfill
дүнгэнэх	v. to buzz, drone
хурхирах	v. to snore
эдлэх	v. to consume, taste
алба	n. employment
хариу	n. answer
гуних	v. to grieve
сэргэлэн	adj. alive, animated
тайван	adj. calm, composed
аргадах	v. appease, coax
дөнгөх	v. to barely do something
шувуухай	n. small bird
цэнхэр	adj. azure, blue
бүгдээрээ	adj. all
нашаа	adv. here
саатах	v. to linger, overstay
үй түмэн	n. multitude
дуугарах	v. clang, clatter
үр	n. kernel, seed
мөхлөг	n. grain, granule
тийш	prep. toward
үртэс	n. chip, crumb
ялгах	v. determine, differentiate, segregate, identify
олз	n. loot, plunder
омог	n. capture, pride, stem, kindred
намуу	n. poppy
цэцгийн	adj. floral
холилдох	v. to blend, jumble
бүгд	n. everybody, everyone
салгах	v. to deliver, detatch, disengage
гадаа	adj. outside
хангинах	v. blare, clang, jingle
шүгэлдэх	v. hiss, whistle
одоо	adv. now
уур	n. anger, wrath, vapor
шүүрэх	v. to grab, percolate, leak, grasp
цангинуулах	v. to shout in a shrill voice
алс	adj. far
амбаар	n. barn
сав	n. can, container, vase, uterus
айл	n. family
оготно	n. mouse
нааш	adv. this way
шуудайлах	v. to put in a bag
аяга	n. cup, bowl
цаагуур	adv. further, other side
шажигнах	v. creak, grate, sputter
навчис	n. leaf
шаржигнах	v. sizzle
пийшин	n. cooker, furnace
чих	n. ear, dock
чагнах	v. listen, monitor
дуулах	v. chant, crow
дуулдах	v. arise, carry
тавиур	n. leg, mat, stand
тавхай	n. foot, sole
хучих	v. envelop, inlay, tuck
дайлах	v. entertain, treat
энхрий	adj. affectionate, beloved, gentle
салах	v. conquer, divide, separate
амин	adj. crucial, essential, important
тод	adj. articulate, bold, bright
түлэх	v. burn, scald, sear
халаах	v. scorch, warm, heat
тус	v. profit, boost, help
хүргэх	v. bring, deliver, extend, touch
бэлэглэх	v. donate, give, present
шунаг	adj. lascivious
ул	n. relic, sole
зугтаах	v. abscond
эрс	adj. categorical, overwhelming
харайх	v. bounce, dance, jump
ороолгох	v. flog
мөчир	n. branch, graft, twig
өнгийн	adj. chromo-
тууз	n. band, ribbon
өлгөх	v. hang, suspend, dangle
хаагдах	v. shut
тос	n. fat, grease, oil
түрхэх	v. dab, paint, smear
сохлох	adj. blind
сугалах	v. draw, extract, pull
суулгах	v. install, diarrhea, embed
зүг	n. direction, way
сэдэх	v. brew, invent, plan, contrive
ёс	n. ceremony, procedure
эрхэмлэх	v. prefer, preference
дээдлэх	v. prefer
уламжлал	v.tradition, legacy
соёл	n. culture
заншил	n. custom, habit, ritual
багаар	adj. less
алдагдал	n. detriment, disadvantage, loss 
суртахуун	n. morals, ethics
доройтох	v. languish, fall
буй	adj. existing
өнөө	adv. now, today
залуусын	adj. junior
санаачлах	v. to initiate, dream up, invent
дээшлүүлэх	v. to upgrade
энэхүү	n. the present
уралдаан	n. race, match
зорилго	n. point, purpose
орших	v. to exist
цацарч	n. marquee
суниах	v. to go
биеийн	adj. personal, bodily
чилэх	v. to go numb
өрөөнд	adj. indoors
зүтгэх	v. to endeavor, to seek
өгөө	n. obligation
гүйн	adv. hurriedly
дураараа	adj. willful, contrary, unsubmissive
хичнээн	how many
хэлтэрхий	n. chip, morsel, fragment
чангаар	adj. loud, high
биз	presumably
ургах	v. fertile, germinate, grow
уяа	n. cord, lacing, line
чимсэн	adj. decorated, ornate
тосолсон	adj. oil
хилэгнэх	v. to get angry
нүдэх	v. knock, pound, flail
эвдэх	v. demolish, scrap
цавчих	v. hack, hew
ядарч	adv. wearily
оронд	adv. instead
эцэх	v. to tire, weary
араас	prep. after
хөөсөн	adj. swollen
загнах	v. admonish, scold
зүхэх	v. abuse, curse
унтрах	v. burn out, die
нэмэр	n. supplement
унтарсан	adj. dead, extinct
ширтэх	v. stare at
гал	n. fire, heat
хатгах	v. bite, incite, instigate
нуугдах	v. hide, shelter, disappear
гүйх	v. to run, frisk
тийнхүү	adv. accordingly, such
цоо	adj. completely
булах	v. bury
хүссэн	adj. impatient, longing
уйтгар	n. boredom, flatness, sadness, weariness
чанар	n. attribute, character
маалинга	n. flax
ээрүүл	n. spindle, spinning wheel
эргэлдэх	v. reel, revolve, whirl
нарийхан	adj. delicate, slim
эвхэх	v. fold
утсаар	v. to wire
даавуу	n. cloth, jeans
торго	n. silk
гоёмсог	adj. elegant, delicate
сүвлэх	n. thread
алдах	v. lose,fail, mistake
зарах	v. sell, exert
ордон	n. castle, palace
аваачих	v. to take away
үнэлэх	v. apprise, price, measure
бэлэг	n. donation, gift, grant
сайшаагдах	v. approve
талархах	v. acknowledge, thank
зүрхлэх	v. dare, presume
тун	adv. absolutely, greatly, very
чиг	n. landmark
эвдэх	v. breach, trample
вий	conj. lest
эсгэх	v. to cut off
айх	v. to recoil
ийм	adj. such
хийц	n. fabric, cloth
оёо	n. stitch
тэгвэл	conj. when...,if...
тушаах	v. to submit, surrender, order
сувд	n. pearl
зарц	n. servant
үзэгдэх	v. to appear
өдрөөс	from day
хойш	adj. next, hence
цагаахан	adj. white
өөрийнхөө	pron. my
удалгүй	adj. soon
хурим	n. wedding
ая	n. situation, condition, sound
тусч	adj. helping
хөөрхөн	adj. cute, nice
халаас	n. pocket
эрхэм	adj. important, master
зочид	n. guests
золгох	v. to meet
дархан	n. artisan, craftsman
хулгай	n. robbery, theft
харуул	n. convoy, escort, guard
манаа	n. guard, patrol, sentinel
болих	v. quit, discontinue
уруу	adj. downhill, downstream, downcast
царай	n. expression, look
гуниглах	n. regret
тайтгаруулах	v. appease, calm, console
хөвгүүдийн	adj. boyish
гутрах	v. gloom, droop
өөрсдөө	pron. themselves
манах	v. to guard, patrol
онцолсон	adj. emphatic
өвсөн	adj. grassy
зүүрмэглэх	v. nap, snooze
хонох	v. sleep, stay over
баярлуулах	v. indulge
эд	n. stuff, thing
нойр	n. dream, slumber
өвс	n. grass, hay, pasture
бүүр	adv. already
модон	adj. wooden
тонших	v. knock, peck
гэтэх	v. creep, sneak, prowl
өд	n. feather, pinion
одох	v. depart
гэмтэн	n. guilt, wrongdoing
хүндэт	adj. dear, honorable
амьтан	n. animal
мултрах	v. to slip away
баярлах	v. appreciate, rejoice, thank
мориор	n. riding
мордох	v. to ride
туулах	v. confront, pass, conquer
нутгийн	adj. native
буун	n. shot, discharge, report
чөдөрлөх	v. clog, fetter
унтаа	adj. dormant
баах	v. defecate
мөлжих	v. gnaw, milk, exploit
унаа	n. movement, transportation
халаглах	n. tut
заяа	n. luck
явган	adj. by foot, pedestrian
үхтлээ	adj. dead
зүлгэх	v. swab, brighten
өрөвдөх	v. pity, sympathize
зориг	n. confidence, daring, nerve
чонын	adj. like a wolf
шүргэх	v. contact, kiss, rub
хурдлах	v. race, lick
торон	adj. lacy, meshy
давах	v. confront, conquer, outdo
өвөр	adj. front, inside
цайз	n. castle, fortress
үлээх	v. inflate, puff, gas
хэц	n. tambourine
бөмбөр	n. drum
дэлдэн	adj. lop eared
сэрээх	v. awaken, rouse
ичгүүр	n. disgrace, humiliation
эцгийн	adj. paternal
хүндлэх	v. honor, regard,respect
шившиг	adj. disgrace, dishonor
даяар	adv. all over, throughout
зарлах	v. advertise, announce
дуугүй	adj. noiseless, silent
өршөөх	v. excuse, pardon, forgive
дэл	n. mane
гунихрах	v. to grieve
гуйх	v. beg, ask
суу	adj. genius
жүчээ	n. stall
орон	n. house, nation, situation
чулуун	adj. stony
шигтгээ	adj. inlaid
санагдах	v. appear, seem
гүнж	n. princess
асрагч	n. guardian, trustee
шивэгчин	n. maidservant
буцах	v. back, forswear, go, return
гүйцэх	v. outpace
олуул	n. flock
зугаалах	v. journey, stroll
дүүрэх	v. fill, pervade, swim
утгах	v. shovel, ladle
хөөх	v. chase away, eject
тэгэхэд	conj. whereas
хаа	n. whereabouts
нуух	v. cloak, conceal
хувирах	v. change, convert
тонгорох	v. somersault, spill
адил	n. analogy
найр	n. ball, feast
хоншоор	n. toe, muzzle
харагдах	v. appear, look
орноос	v. to get up out of bed
харамсах	v. to regret, be disappointed
хөтлөх	v. lead, prosecute
төрөлх	v. inherent, inborn, natural
бэгийн	adj. donative, gratuitous
авчруулах	v. send for
цочирдох	v. shocked
падхийн унар	n. thud
хүндэтгэх	v. adore, appreciate
үүр	n. cell, dawn, daylight
үүрд	n. eternity
биелэх	v. materialize
нутаг	n. habital, land
шийдэх	v. decide, conclude
хуваах	v. divide, bisect
хоосан	adj. deceitful, futile, bare, empty
дайралдах	v. to come across something
хамаг	adj. everything
тохиролцох	v. arrange, bargain, concert
айлгах	v. endanger, bluff, frighten, intimidate
сүрдүүлэх	v. browbeat, intimidate
зуурах	v. grip, deadlock
билгийн	adj. fateful
мөнхийн	adj. eternal, everlasting
суллах	v. discharge, release
тул	conj. because, on account of
шарх	v. cut, wound
аних	v. close
эдгэрэх	v. recover
сэргэх	v. awaken
омгийн	adj. tribal
алах	v. assassinate, kill
тараах	v. carry, chase, dismiss
өөртөө	pron. oneself
аян	n. campaign, crusade, expidition
тайтгарах	v. quieten
жаргах	v. delight, pleasure
дүү	n. cousin
элдэх	v. crumple
элбэг	adj. bountiful, copious
дэлбэг	adj. lavish, luxuriant
агуулах	v. embody, store, reservoir
арвай	n. barley
бужигнах	v. to be muddled
орчин	n. environment
амжуулах	v. to manage in
хичээх	v. to take care, struggle
өмсүүлэх	v. to wear
гялс	adv. passingly
дуусгах	v. to finish
мундаг	adj. huge
аягүй	adj. unbecoming
бараг	adj. A kind of ___,almost/nearly something____
эртхэн	adjv. go without delay
оруулах	v. to introduce, set up, go
бэлдэх	v. to prepare
хань	n. partner
гайгүй	adj. not too bad
таших	v. clap
нуга	n. lawn
бэлчих	v. graze
хөвсгөр	adj. fryable
намаг	n. swamp
намгийн	adj. growing in a wet or swampy area
атга	n. handful
чимх	v. handful
ширхэг	n. fiber, piece
аргаа барсан	adj. desperate
зээлдүүлэх	v. lend, loan
тэг	n. nothing
гадар	n. outside, jacket, surface
өгөөрэй	interj. please
зайл	adj. away
өр	n. debt, liability
зээл	n. credit, loan
тавь	adj. fifty
гомдоох	v. annoy, grieve
өлөн	adj. hungry
хоосон	adj. blank, deceitful, futile
дэггүйтэх	v. wanton
чиглэх	v. focus, steer, trend
асар	n. citadel, pavilion, tent
царс	n. oak
хонгил	n. basement, corridor, tunnel
хийсгэх	v. blow away
харих	v. return, reverse
төлөө	prep. for, on behalf of
шидэт	n. wizard, fairy
бүтээлгийг авах	v. uncover
бүхэн	adj. each
доошоо	prep. down
гоо	adj. pretty
амралт	n. vacation
залгах	v. plug in
бассейн	n. pool
тэгэнгээ	conj. while
уралдах	v. to race
хаачих	v. where are you going
ийш	adv. here
бөөнөөрөө	adv. quickly
захиалах	v. order
хага	n. burst
соруулах	v. suck
холдох	v. to withdraw
алив	phrase. let's
онгоц	n. plane
динозавр	n. dinosaur
буух	v. get off
цадтал	adv. to glut
ундлах	v. offer food
атаархах	v. envy
бүлтийх	v. stare
тэнд	adv. there
манайх	n. house
бүлэх	v. jab, stab
бүтээлэг	n. blanket
өрөг	n. game
бий	v. have
дэлгэх	v. display
атаархах	v.envy
улайх	v. confess, flush, redden
цатгалан	adj. satiated
элэгсэг	adj. loving
үдэх	v. see off
ижил	adj. same
унд	n. dish, beverage
цэмцийх	v. to become element
бүтээл	n. invention, work
гаслах	v. to mourn
зоорь	n. cellar